1111111111111
1100000111111
1111110C00011
11P0110001111
1100000111111
1110110001111
111E110C00011
1111111111111