11111111111111111111111111
111100C0000000000000011111
11110000001111011111111111
11111111111111011111111111
11100000000000000111111111
110000110P0011100001111111
1111100000000000C001111111
11100000011111111111111111
11111110000000111111111111
11111111111100001111111111
111111100000000000000E1111
11111111111100001111111111
111C0000000000111111111111
11111111001111111111111111
11111111111111111111111111